Institution Name,State,Applied,NYA,Accepted,Matric
Albany Medical College,NY,113,113,0,0
Albert Einstein College of Medicine,NY,77,77,0,0
Anne Burnett Marion School of Medicine at TCU,TX,50,45,5,0
Baylor College of Medicine,TX,1,1,0,0
Boston University Aram V. Chobanian & Edward Avedisian School of Medicine,MA,87,83,4,0
Brody School of Medicine at East Carolina University,NC,1,1,0,0
California Northstate University College of Medicine,CA,95,87,8,0
California University of Science and Medicine,CA,133,126,7,0
Carle Illinois College of Medicine,IL,25,25,0,0
Case Western Reserve University School of Medicine,OH,50,45,5,0
Central Michigan University College of Medicine,MI,41,41,0,0
Charles E. Schmidt College of Medicine at Florida Atlantic University,FL,27,26,1,0
Charles R. Drew University Of Medicine and Science College of Medicine,CA,13,12,1,0
Chicago Medical School at Rosalind Franklin University of Medicine & Science,IL,98,93,5,0
Columbia University Vagelos College of Physicians and Surgeons,NY,35,35,0,0
Cooper Medical School of Rowan University,NJ,28,28,0,0
Creighton University School of Medicine,NE,54,49,5,0
Donald and Barbara Zucker School of Medicine at Hofstra/Northwell,NY,43,43,0,0
Drexel University College of Medicine,PA,115,112,3,0
Duke University School of Medicine,NC,40,40,0,0
East Tennessee State University James H. Quillen College of Medicine,TN,11,11,0,0
Eastern Virginia Medical School,VA,53,53,0,0
Emory University School of Medicine,GA,84,84,0,0
Florida International University Herbert Wertheim College of Medicine,FL,29,28,1,0
Florida State University College of Medicine,FL,15,15,0,0
Frank H. Netter MD School of Medicine at Quinnipiac University,CT,63,60,3,0
Frederick P. Whiddon College of Medicine at the University of South Alabama,AL,1,1,0,0
Geisel School of Medicine at Dartmouth,NH,70,68,2,0
Geisinger Commonwealth School of Medicine,PA,33,33,0,0
George Washington University School of Medicine and Health Sciences,DC,134,134,0,0
Georgetown University School of Medicine,DC,124,120,4,0
Hackensack Meridian School of Medicine,NJ,46,43,3,0
Harvard Medical School,MA,39,39,0,0
Howard University College of Medicine,DC,29,29,0,0
Icahn School of Medicine at Mount Sinai,NY,57,57,0,0
Indiana University School of Medicine,IN,31,30,1,0
Jacobs School of Medicine and Biomedical Sciences at the University at Buffalo,NY,43,42,1,0
Johns Hopkins University School of Medicine,MD,27,27,0,0
Joint Medical Program UC B/SF,CA,2,2,0,0
Kaiser Permanente Bernard J. Tyson School of Medicine,CA,137,135,2,0
Keck School of Medicine of the University of Southern California,CA,172,162,10,0
Kirk Kerkorian School of Medicine at UNLV,NV,15,15,0,0
Lewis Katz School of Medicine at Temple University,PA,92,91,1,0
Loma Linda University School of Medicine,CA,64,63,1,0
Louisiana State University School of Medicine in New Orleans,LA,14,14,0,0
Louisiana State University School of Medicine in Shreveport,LA,12,12,0,0
Loyola University Chicago Stritch School of Medicine,IL,83,80,3,0
Marshall University Joan C. Edwards School of Medicine,WV,3,3,0,0
Mayo Clinic Alix School of Medicine,MN,42,41,1,0
Medical College of Georgia at Augusta University,GA,5,5,0,0
Medical College of Wisconsin,WI,60,59,1,0
Medical University of South Carolina College of Medicine,SC,4,4,0,0
Meharry Medical College,TN,27,27,0,0
Michigan State University College of Human Medicine,MI,36,35,1,0
Morehouse School of Medicine,GA,20,19,1,0
NYU Grossman School of Medicine,NY,54,54,0,0
NYU Long Island School of Medicine,NY,30,30,0,0
New York Medical College,NY,94,90,4,0
Northeast Ohio Medical University,OH,19,16,3,0
Northwestern University The Feinberg School of Medicine,IL,53,53,0,0
Nova Southeastern University Dr. Kiran C. Patel College of Allopathic Medicine,FL,28,27,1,0
Oakland University William Beaumont School of Medicine,MI,60,58,2,0
Ohio State University College of Medicine,OH,43,43,0,0
Oregon Health & Science University School of Medicine,OR,62,62,0,0
Pennsylvania State University College of Medicine,PA,79,79,0,0
Perelman School of Medicine at the University of Pennsylvania,PA,25,25,0,0
Ponce Health Sciences University School of Medicine,PR,5,4,1,0
Renaissance School of Medicine at Stony Brook University,NY,29,28,1,0
"Robert Larner, M.D., College of Medicine at the University of Vermont",VT,86,84,2,0
Rush Medical College of Rush University Medical Center,IL,83,81,2,0
Rutgers New Jersey Medical School,NJ,26,26,0,0
"Rutgers, Robert Wood Johnson Medical School",NJ,28,27,1,0
SUNY Downstate Health Sciences University College of Medicine,NY,54,52,2,0
Saint Louis University School of Medicine,MO,43,43,0,0
San Juan Bautista School of Medicine,PR,2,2,0,0
Sidney Kimmel Medical College at Thomas Jefferson University,PA,85,82,3,0
Southern Illinois University School of Medicine,IL,1,1,0,0
Spencer Fox Eccles School of Medicine at the University of Utah,UT,14,14,0,0
Stanford University School of Medicine,CA,97,95,2,0
State University of New York Upstate Medical University Alan and Marlene Norton College of Medicine,NY,40,40,0,0
Texas A&M Uni. System HSC Col. of Medicine,TX,1,1,0,0
Texas A&M University School of Medicine,TX,1,1,0,0
The University of Toledo College of Medicine and Life Sciences,OH,38,38,0,0
The Warren Alpert Medical School of Brown University,RI,61,61,0,0
Tufts University School of Medicine,MA,105,102,3,0
Tulane University School of Medicine,LA,104,100,4,0
UCLA/Drew Medical Education Program,CA,40,39,1,0
USF Health Morsani College of Medicine,FL,33,26,7,0
UT Southwestern,TX,1,1,0,0
Uniformed Services University of the Health Sciences F. Edward Hebert School of Medicine,MD,10,9,1,0
University of Alabama at Birmingham Marnix E. Heersink School of Medicine,AL,12,12,0,0
University of Arizona College of Medicine - Phoenix,AZ,91,87,4,0
University of Arizona College of Medicine â€“ Tucson,AZ,71,70,1,0
University of Arkansas for Medical Sciences College of Medicine,AR,7,7,0,0
"University of California, Davis, School of Medicine",CA,181,176,5,0
"University of California, Irvine, School of Medicine",CA,188,183,5,0
"University of California, Los Angeles David Geffen School of Medicine",CA,156,154,2,0
"University of California, Riverside School of Medicine",CA,161,159,2,0
"University of California, San Diego School of Medicine",CA,184,178,6,0
"University of California, San Francisco, School of Medicine",CA,135,134,1,0
University of Central Florida College of Medicine,FL,21,20,1,0
University of Chicago Division of the Biological Sciences The Pritzker School of Medicine,IL,41,40,1,0
University of Cincinnati College of Medicine,OH,43,42,1,0
University of Colorado School of Medicine,CO,101,99,2,0
University of Connecticut School of Medicine,CT,15,15,0,0
University of Florida College of Medicine,FL,13,13,0,0
"University of Hawaii, John A. Burns School of Medicine",HI,36,36,0,0
University of Illinois College of Medicine,IL,56,52,4,0
University of Iowa Roy J. and Lucille A. Carver College of Medicine,IA,18,17,1,0
University of Kansas School of Medicine,KS,9,9,0,0
University of Kentucky College of Medicine,KY,11,11,0,0
University of Louisville School of Medicine,KY,15,15,0,0
University of Maryland School of Medicine,MD,33,33,0,0
University of Massachusetts T.H. Chan School of Medicine,MA,30,27,3,0
University of Miami Leonard M. Miller School of Medicine,FL,80,78,2,0
University of Michigan Medical School,MI,63,63,0,0
University of Minnesota Medical School,MN,23,23,0,0
University of Missouri-Columbia School of Medicine,MO,12,11,1,0
University of Missouri-Kansas City School of Medicine,MO,5,5,0,0
University of Nebraska College of Medicine,NE,8,8,0,0
"University of Nevada, Reno School of Medicine",NV,14,14,0,0
University of New Mexico School of Medicine,NM,3,3,0,0
University of North Carolina at Chapel Hill School of Medicine,NC,27,26,1,0
University of North Dakota School of Medicine and Health Sciences,ND,3,3,0,0
University of Oklahoma College of Medicine,OK,3,3,0,0
University of Pittsburgh School of Medicine,PA,51,51,0,0
University of Rochester School of Medicine and Dentistry,NY,45,45,0,0
University of South Carolina School of Medicine Columbia,SC,7,7,0,0
University of South Carolina School of Medicine Greenville,SC,10,10,0,0
"University of South Dakota, Sanford School of Medicine",SD,1,1,0,0
University of Tennessee Health Science Center College of Medicine,TN,4,4,0,0
University of Texas Medical Branch,TX,1,1,0,0
University of Texas Medical School at Houston,TX,1,1,0,0
University of Texas Medical School at San Antonio,TX,2,2,0,0
University of Virginia School of Medicine,VA,23,21,2,0
University of Washington School of Medicine,WA,60,60,0,0
University of Wisconsin School of Medicine and Public Health,WI,36,35,1,0
Vanderbilt University School of Medicine,TN,30,29,1,0
Virginia Commonwealth University School of Medicine,VA,58,55,3,0
Virginia Tech Carilion School of Medicine,VA,46,45,1,0
Wake Forest University School of Medicine,NC,79,78,1,0
Washington State University Elson S. Floyd College of Medicine,WA,14,14,0,0
Washington University in St. Louis School of Medicine,MO,26,26,0,0
Wayne State University School of Medicine,MI,62,60,2,0
Weill Cornell Medicine,NY,43,43,0,0
West Virginia University School of Medicine,WV,23,22,1,0
Western Michigan University Homer Stryker M.D. School of Medicine,MI,36,33,3,0
Wright State University Boonshoft School of Medicine,OH,23,23,0,0
Yale School of Medicine,CT,41,41,0,0